15 15
4
1 1
13 1
1 13
13 13
WWWWWWWWWWWWWWW
WS_+++++++++_SW
W_X+X+X+X+X+X_W
W+++++++++++++W
W+X+X+X+X+X+X+W
W++++G+++G++++W
W+X+X+X_X+X+X+W
W+++++___+++++W
W+X+X+X_X+X+X+W
W++++G+++G++++W
W+X+X+X+X+X+X+W
W+++++++++++++W
W_X+X+X+X+X+X_W
WS_+++++++++_SW
WWWWWWWWWWWWWWW